11111111111111111111111111111
10000000000000000000000100001
10000000000000000000000100001
1000000P000000000011110100001
100000000000000000C0001111111
10000000000000000000010000001
1000000111100000C000010111001
100000000000000000000001E0001
11111111111111111111111111111
