11111111111111111111111111111
10000000000000000000000000001
10000000000000000000000000001
1000000P000000000000000000001
100000000000000000C0000000001
10000000000000000000000000001
1000000000000000C000000C00001
100000000000000000000000E0001
11111111111111111111111111111