1111111111
10C0000001
1100000001
1P00000001
10000000C1
1000000001
1E00000C01
1111111111
