1111111111111111111111111111111111111111
10000000000000000000000000000000000000P1
1000000000000001111111111111111111111111
1000000000000000000011111111111111111111
1000111111110000000011111111111111111111
10C00000000000000000000000000C00000000C1
1000000000000000000000000000000000C000C1
10000000000C0000000011111111111111111111
1101001000000000000000000000000000000001
11010010000000000C0000000000000000000001
11C1111000000000000000000000000000000001
11111111C00000000C00000000000000000000E1
1111111111111111111111111111111111111111